A00000001100
100000000000
111111111000
000010010001
011111001101
010001110000
00000B000000